办法 深深 动作 气质 衣服 无与伦比 apec 世界杯 挑战 冰桶 	形容 记得 叫做 肆虐 奔跑 关注 优雅 萌萌 罚款 任性 
魅力 apec 新浪 少年 镜头 娱乐 感谢 峰峰 李易峰 微博 	表演 知道 期待 惊喜 说谎 感谢 承诺 参与 努力 大胆 
apec 之前 功劳 领导人 企图 联系 程老大 程守宗 国宴 会议 	筹划 说服 辛苦 说明 设计 各国 销售 喜欢 购买 工作 
apec 北京 会议 博文 期间 常态 装笑 挠心 blue 天空 	无法 打错 悲愤 解除 转载 成为 享受 吐槽 怀念 想想 
广场 观赏 滕王阁 秋水 游轮 景区 赣江 西岸 apec 中国 	承受 无法 不好 造成 注意 任性 腐败 呼吸 抓住 投票 
烟花 apec 赣江 时间 南昌 江心洲 李渡 效果 地点 最佳 	燃放 发射 最高 攻略 环保 停车赏 受罚 提醒 主打 来自 
apec 终于 假期 希望 新年 绞尽脑汁 千思万 中国 天气 愿望 	实现 接触 前期 觉得 生活 快乐 期待 过去 迎接 之后 
方案 中国 机会 付诸实施 峰会 apec 期待 北京 环境 焰火 	期望 采纳 请求 发言 降低 污染 有所 改善 修订 施行 
apec 北京 空气 雾霾 蓝天 期间 会议 质量 汽车 中国 	污染 治理 限行 排放 严重 停产 出现 改善 希望 努力 
apec 全体 参与者 中国 行货 黑莓 转发 公交 地铁 网络 	表演 值得 呈现 谢谢 记录 回到 支持 提出 养眼 互访 
apec 领导人 宫殿 志愿者 青年 雁栖岛 专机 导弹 哪家 会议 	参观 预约 开放 定位 正式 面向 工作 超过 安全 公认 
apec 中国 美国 签证 经济 世界 国家 and 日本 奥巴马 	旅行 免签 改革 旅游 成为 关注 发展 完美 反腐 延长 
apec 中国 会议 北京 报告 常态 峰会 新闻 经济 领导人 	能否 发展 举办 留住 不错 阅读 重要 活动 工作 治国 
互联网 阿里巴巴 斯里兰卡 印度 apec 马尔代夫 思维 塔吉克斯坦 北京 问题 	微博 下载 生活 达成 导致 任性 知道 改变 说说 响亮 
鲜肉 手滑 apec 啤酒 哪家 辣条 逼格 根本 整个 时间 	下来 任性 萌萌 蛮拼 不好 珍惜 炸鸡 开开 加油 寻找 
apec 会议 中心 国际 北京 期间 分享 峰会 博文 雁栖湖 	服务 分享 参加 看看 完全 期待 指定 保证 知道 各国 
apec 马航 失联 北京 会议 期间 上海 公交 亚航 地铁 	知道 期待 上班 吐槽 结束 准备 怀念 发生 活动 想到 
会议 签证 apec 小鸡 辣条 政策 北京 时间 结束 两千 	出国 微博 重视 引起 支持 回复 恢复 可惜 迅速 勒个 
北京 交通 城市 apec 蓝天 拥堵 根本 全世界 焕然一新 峰会 	解决 可望 常见 看到 快乐 授权 转发 恶搞 限号 自由 
峰会 中小企业 apec economic 会议 经济 理事会 cooperation 工商 组织 	咨询 合作 感动 喜欢 萌萌 挑战 意味着 连续 升级 著名 
